111111111111111111111111111111111111111111
110000000001111111100000000000000000000001
111111111101111111000000011110000000000001
100000000000000010000000011111111111110001
111101111111111111000001111111E00111110001
100000000000000000000000000111110001111001
101111000C00001111000000000000111101110001
100011110000111111100000000000000000000001
111011000000011111000000000000000000000001
11101111110C000000000000000000000000000001
110P11111110000000000000000000000000000101
110000111111110000000000000111111000000001
111110000111111000000001111111111110000001
100000001111110000000000111111111000000111
101111111111100000111000001111100000111111
100000000000000000111111100000000000011111
100000000000000011111111000000000000000001
100000001111100000011000000000111100000001
100111111111111100000000011111111111110001
100001111111111000000001111111000001111001
100000001111111001111100111110011111100001
101110000000000000111000000110110000000001
111111110000000001111110000000000000011111
111111111100000111111111000000000111111111
111111111111111111111111111111111111111111