11111111111111111111111111
10000000000010000000000001
100000P0000000000000CCC001
10000000000011110000CCC001
1111011111111CC10000000001
1000000000001CC11111100001
10111111111010000000000111
10100000001010001CCCC10001
10101CEC101010001CCCC10001
10101111101010111111111101
101000000010100000000001C1
101111011110101111101101C1
100000000000100000000001C1
11111111111111111111111111
